SSS#############
S...........#..#
S..#..#######..#
#..#..#..#.....#
#..####..####..#
#..............#
#######..#######
#..#...........#
#..#..#..####..C
#.....#.....#..C
#############CCC